x,x,I,x,x,x,x,x,x,x,
x,f,f,f,f,f,f,f,f,x,
x,i,m,f,m,f,m,f,f,x,
x,f,f,f,f,f,f,f,f,x,
x,f,h,f,f,f,f,f,f,x,
x,f,f,f,f,f,f,f,f,x,
x,f,f,f,f,m,f,f,f,x,
x,f,f,f,f,f,f,f,f,x,
x,f,f,f,f,f,f,f,f,x,
x,x,O,x,x,x,x,x,x,x,
